--------------------
|* **   **    *   *|
|       *          |
|     *     *  *   |
|    *   *     * * |
|  *         K     |
|  *       D  **  *|
|  *    *       * *|
|      *   *     * |
|  *       *  *    |
|P***       *      |
|  *   *    * *   *|
|  * *         *   |
--------------------