--------------------
|* *    **    *   *|
|       *          |
|     *     *  *   |
|    *   *     * * |
|  *         K     |
|  *          **  *|
|  *    *       * *|
|      *   *     * |
|  * *     *  *    |
|P***  * *  *      |
|  ** **    *     *|
|  D           *   |
--------------------