K --------------------------
| *      *                 |
| * ****   *************** |
| * *    * *               |
| * **** * * **************|
| * *    * * *             |
| * * **** *** *********** |
| * * *        *           |
|       ****************** |
|********    * * *       * |
| *       **** * ******* * |
| * *** ***  * * *       * |
|   *       **   * ***** * |
|**** *******  * *     * * |
|     *       ** ** **** * |
| ***** *******     *      |
|       *       ***********|
|****** *********        * |
|       *         ******** |
| ******* ****** **   *    D
|         *         *   ** |
----------------------------