K ########
#        #
# ### ## #
# #    # #
# #  # # #
# ##P#####
# #      #
# # #  # #
##### ####
#   #    D
# #    # #
##########