----------------
|              |
| *  * *  ***  |
| *  ***    *  |
| *         * D|
|K*            |
----------------