-------------------
|     *           |
|     *           |
|     *           |
|  D  *       P   |
|     **          |
|     **          |
|     **          |
|     **          |
|     *K          |
|      * *        |
-------------------
