---------
|   P   |
|K*****D|
| *   * |
---------