----------------
|     P        |
| *  * *  ***  |
| *  ***    *  |
| *         * D|
|K*            |
----------------