--------------------------
|  *                     |
|  **********            |
| K        P* *          |
|  *        *            |
|    *      *D        *  |
|  ********************  |
|                        |
|                        |
--------------------------