--------------------------
|  *                     |
|  **********            |
| K    *   P* *    ****  |
|  *        *         *  |
|    *      *D        *  |
|  ********************  |
|           *            |
|            *        * *|
--------------------------