------------------
|                |
|                |
|                |
|            *  *|
|***             |
|  *             |
|  *** K* * *    |
|PD****     *   *|
------------------
